{
    "sprite":   {
        "filename":                         "images/punti_jordan_tiles.png",
        "frameWidth":                       64,
        "frameHeight":                      64,
        "framesPerLine":                    3
    },

    "width":                                32,
    "height":                               16,

    "map": [
        0, 0, 0, 0, 0, 0, 0, 0, 0, 0, 0, 1, 2, 2, 2, 3, 0, 0, 0, 0, 0, 0, 0, 0, 0, 0, 0, 0, 0, 0, 0, 0, 
        0, 0, 0, 0, 0, 0, 0, 0, 0, 0, 0, 4, 5, 5, 5, 6, 0, 0, 0, 0, 0, 0, 0, 0, 0, 0, 0, 0, 0, 0, 0, 0,
        2, 2, 2, 3, 0, 0, 1, 2, 2, 2, 2, 5, 5, 5, 5, 6, 2, 2, 2, 2, 2, 2, 2, 2, 3, 0, 0, 0, 1, 2, 2, 1,
        5, 5, 5, 6, 0, 0, 4, 5, 5, 5, 5, 5, 5, 5, 5, 5, 5, 5, 5, 5, 5, 5, 5, 5, 6, 0, 0, 0, 4, 5, 5, 6,
        5, 5, 5, 6, 0, 0, 4, 5, 5, 5, 5, 5, 5, 5, 5, 5, 5, 5, 5, 5, 5, 5, 5, 5, 6, 0, 0, 0, 4, 5, 5, 6,
        2, 2, 2, 2, 2, 2, 2, 2, 2, 2, 2, 2, 2, 2, 2, 2, 2, 2, 2, 2, 2, 2, 2, 2, 2, 2, 2, 2, 2, 2, 2, 2,
        5, 5, 5, 5, 5, 5, 5, 5, 5, 5, 5, 5, 5, 5, 5, 5, 5, 5, 5, 5, 5, 5, 5, 5, 5, 5, 5, 5, 5, 5, 5, 5, 
        5, 5, 5, 5, 5, 5, 5, 5, 5, 5, 5, 5, 5, 5, 5, 5, 5, 5, 5, 5, 5, 5, 5, 5, 5, 5, 5, 5, 5, 5, 5, 5, 
        5, 5, 5, 5, 5, 5, 5, 5, 5, 5, 5, 5, 5, 5, 5, 5, 5, 5, 5, 5, 5, 5, 5, 5, 5, 5, 5, 5, 5, 5, 5, 5, 
        5, 5, 5, 5, 5, 5, 5, 5, 5, 5, 5, 5, 5, 5, 5, 5, 5, 5, 5, 5, 5, 5, 5, 5, 5, 5, 5, 5, 5, 5, 5, 5, 
        5, 5, 5, 5, 5, 5, 5, 5, 5, 5, 5, 5, 5, 5, 5, 5, 5, 5, 5, 5, 5, 5, 5, 5, 5, 5, 5, 5, 5, 5, 5, 5, 
        5, 5, 5, 5, 5, 5, 5, 5, 5, 5, 5, 5, 5, 5, 5, 5, 5, 5, 5, 5, 5, 5, 5, 5, 5, 5, 5, 5, 5, 5, 5, 5, 
        5, 5, 5, 5, 5, 5, 5, 5, 5, 5, 5, 5, 5, 5, 5, 5, 5, 5, 5, 5, 5, 5, 5, 5, 5, 5, 5, 5, 5, 5, 5, 5, 
        5, 5, 5, 5, 5, 5, 5, 5, 5, 5, 5, 5, 5, 5, 5, 5, 5, 5, 5, 5, 5, 5, 5, 5, 5, 5, 5, 5, 5, 5, 5, 5, 
        5, 5, 5, 5, 5, 5, 5, 5, 5, 5, 5, 5, 5, 5, 5, 5, 5, 5, 5, 5, 5, 5, 5, 5, 5, 5, 5, 5, 5, 5, 5, 5, 
        5, 5, 5, 5, 5, 5, 5, 5, 5, 5, 5, 5, 5, 5, 5, 5, 5, 5, 5, 5, 5, 5, 5, 5, 5, 5, 5, 5, 5, 5, 5, 5
    ],

    "solid": [
        {
            "position":                         [0.0, 0.0],
            "dimensions":                       [0.0, 0.0],
            "shapeType":                        "CST_BOX"
        },
        {
            "position":                         [0.0, 0.0],
            "dimensions":                       [64.0, 64.0],
            "shapeType":                        "CST_BOX"
        },
        {
            "position":                         [0.0, 0.0],
            "dimensions":                       [64.0, 64.0],
            "shapeType":                        "CST_BOX"
        },
        {
            "position":                         [0.0, 0.0],
            "dimensions":                       [64.0, 64.0],
            "shapeType":                        "CST_BOX"
        },
        {
            "position":                         [0.0, 0.0],
            "dimensions":                       [0.0, 0.0],
            "shapeType":                        "CST_BOX"
        },
        {
            "position":                         [0.0, 0.0],
            "dimensions":                       [0.0, 0.0],
            "shapeType":                        "CST_BOX"
        }
    ]
}